NO ./textures/north.xpm
SO ./textures/south.xpm
WE ./textures/west.xpm
EA ./textures/east.xpm

F 220,100,0
C 225,30,0

1111111111111111111111111
100S000000110000000000001
101X000001110000000000001
1001000000000000000000001
1011000001110000000000001
1000000001110111111111111
1111011111111101110000101
1111011111111101110101001
1100000011010101110000101
1000000000000000110000101
1000000000000000110101001
1100000111010100110000111
1111011110101001011110101
1111111111111111111111111
