NO ./textures/Doom/north.xpm
SO ./textures/Doom/south.xpm
WE ./textures/Doom/west.xpm
EA ./textures/Doom/east.xpm

F 139,69,19
C 0,0,0
D ./textures/door/door.xpm

111111111111111
100000000000001
101110111110101
101000000010101
101011111010101
100010000010001
111010111011101
100000100000001
101111101110101
100000000000101
101110111110101
100010000010001
100010111010001
100000000000S01
111111111111011
100000000001011
111111111111111