NO ./textures/Funny/NO.xpm
SO ./textures/Funny/SO.xpm
WE ./textures/Funny/WE.xpm
EA ./textures/Funny/EA.xpm

F ./textures/Funny/Floor.xpm
C ./textures/Funny/Ceiling.xpm
D ./textures/door/door.xpm

111111111111111111111111111111111
101001000000000000000000000000001
101001000000000000000000000000001
1D0001000011111000000000000000001
1000010000D0001000000000000000001
100001000010001000000000000000001
10000D000011111000000000000000001
111111111111111111111111111111111
