NO ./textures/Funny/NO.xpm
SO ./textures/Funny/SO.xpm
WE ./textures/Funny/WE.xpm
EA ./textures/Funny/EA.xpm

F ./textures/Funny/Floor.xpm
C ./textures/Funny/Ceiling.xpm

11111111111111111111
10ajhsajh00000000001
10000000000000000011
1N000000000000000001
11111111111111111111
